{
  "é": "ゑ",
  "è": "ゐ",
  "É": "を",
  "È": "ゆ",
  "â": "ヱ",
  "ï": "ヰ",
  "ö": "あ",
  "ó": "い",
  "×": "お"
}
